....................
....||||||||||||||||
....|..............|
....|..||||||||||..|
....|..|........|..|
....|..|..||||..|..|
....|..|..|..|..|..|
....|..|..|..|..|..|
....|..|..|..|..|..|
....|..|..|..|..|..|
....|..|..|..|..|..|
....|..|..|..|..|..|
....|..|..|..|..|..|
....|..|..|..|..|..|
....|..|..|..|..|..|
....|..|..|..|..|..|
....|..|..|..|..|..|
....|.....|.....|..|
....||||||||||||||.|
....................