....||||||||||||||||
|..................|
|..................|
|..................|
|...|..........|...|
|...|..........|...|
|...|..........|...|
|||||||||..|||||||||
|.......|..|.......|
|.......|..|.......|
|..................|
|.......|..|.......|
|.......|..|.......|
|||||||||..|||||||||
|..................|
|..................|
|..................|
|..................|
|..................|
||||||||||||||||||||