..||||||||||||||||||
|...||||||||||||||||
|..................|
|..................|
|......|||||||.....|
|......|..|..|.....|
|......|.....|.....|
|......|.....|.....|
|......|.....|.....|
|......|.....|.....|
|......|.....|.....|
|......|.....|.....|
|...|..|.....|..|..|
|...|..|.....|..|..|
|...|..|.....|..|..|
|...|..|.....|..|..|
|...|..|.....|..|..|
|...|...........|..|
|..................|
||||||||||||||||||||